111111111111111111
10EKPC011111111111
111111111111111111
111111111111111111