1111111111111111111111111111111111111111
1000001000000000000111111111111111111111
1000001000000000000111111111111111111111
1000001000000000000111111111111111111111
1111111111111111111110000010000000000001
1000001000000000000110000010000000000001
1000000K000000E00P0110000010000000000001
1000000C00000000000110000010000000000001
1000000C00001100000110000010000000000001
1000001000000000000110000010000000000001
1111111111111111111110000010000000000001
1111111111111111111111111111111111111111