11111111111111111111111111111111111111111111111111111111111111111111111111111111111
1P000010000000000001111111111111111111111111111111111111111111111111111111111111111
10000010000000000001111111111111111111111111111111111111111111111111111111111111111
10000010000000000001111111111111111111111111111111111111111111111111111111111111111
11111111111111111111100000100000000000011111111111111111111111111111111111111111111
10000010000000000001100000100000000000011111111111111111111111111111111111111111111
1000000K000000E00001100000100000000000011111111111111111111111111111111111111111111
1000000C000000000001100000100000000000011111111111111111111111111111111111111111111
1000000C000011000001100000100000000000011111111111111111111111111111111111111111111
10000010000000000001100000100000000000011111111111111111111111111111111111111111111
11111111111111111111100000100000000000011111111111111111111111111111111111111111111
11111111111111111111111111111111111111111111111111111111111111111111111111111111111