11111111111111111111
10000010000000000001
1000000K000000E00P01
1000000C000000000001
11111111111111111111