11111111111111111111
100000C0000E00000001
10000EEEEECCCC000P01
10000000CCCC00000001
11111111111111111111